Mouse Island Test
100
10
10
0 0 0 2 0 0 0 0 0 0
0 1 1 1 1 1 1 1 1 0
0 1 1 1 1 1 1 1 1 0
0 1 1 3 1 1 6 1 1 0
0 1 1 1 1 1 1 1 1 0
0 1 1 1 1 1 1 1 1 0
0 1 1 5 1 1 1 1 1 0
0 1 1 1 1 4 1 1 1 2
0 1 1 1 1 1 1 1 1 0
0 0 0 0 0 0 0 0 0 0